{
  "id": 8,
  "name": "Castle Siege",
  "bricks": {
    "rows": 7,
    "cols": 8,
    "layout": [
      [0, 0, 0, 3, 3, 0, 0, 0],
      [0, 0, 3, 3, 3, 3, 0, 0],
      [0, 3, 3, 3, 3, 3, 3, 0],
      [3, 3, 3, 3, 3, 3, 3, 3],
      [2, 2, 2, 2, 2, 2, 2, 2],
      [1, 1, 1, 1, 1, 1, 1, 1],
      [3, 3, 3, 3, 3, 3, 3, 3]
    ]
  },
  "ballSpeed": 7.5,
  "lives": 2,
  "powerUpChance": 0.5
} 