{
  "id": 10,
  "name": "Starry Night",
  "bricks": {
    "rows": 7,
    "cols": 8,
    "layout": [
      [0, 0, 0, 3, 3, 0, 0, 0],
      [0, 0, 3, 0, 0, 3, 0, 0],
      [0, 3, 0, 0, 0, 0, 3, 0],
      [3, 0, 0, 2, 2, 0, 0, 3],
      [0, 3, 0, 0, 0, 0, 3, 0],
      [0, 0, 3, 0, 0, 3, 0, 0],
      [0, 0, 0, 3, 3, 0, 0, 0]
    ]
  },
  "ballSpeed": 8.5,
  "lives": 2,
  "powerUpChance": 0.6
} 