{
  "id": 6,
  "name": "Diamond Cutter",
  "bricks": {
    "rows": 7,
    "cols": 8,
    "layout": [
      [0, 0, 0, 3, 3, 0, 0, 0],
      [0, 0, 2, 2, 2, 2, 0, 0],
      [0, 1, 3, 3, 3, 3, 1, 0],
      [1, 2, 3, 3, 3, 3, 2, 1],
      [0, 1, 3, 3, 3, 3, 1, 0],
      [0, 0, 2, 2, 2, 2, 0, 0],
      [0, 0, 0, 3, 3, 0, 0, 0]
    ]
  },
  "ballSpeed": 6.5,
  "lives": 3,
  "powerUpChance": 0.4
} 