{
  "id": 4,
  "name": "Pyramid Power",
  "bricks": {
    "rows": 6,
    "cols": 8,
    "layout": [
      [0, 0, 0, 3, 3, 0, 0, 0],
      [0, 0, 2, 2, 2, 2, 0, 0],
      [0, 1, 3, 3, 3, 3, 1, 0],
      [1, 2, 2, 2, 2, 2, 2, 1],
      [2, 3, 3, 3, 3, 3, 3, 2],
      [3, 3, 3, 3, 3, 3, 3, 3]
    ]
  },
  "ballSpeed": 5.5,
  "lives": 4,
  "powerUpChance": 0.3
} 