{
  "id": 9,
  "name": "Spiral Maze",
  "bricks": {
    "rows": 6,
    "cols": 8,
    "layout": [
      [3, 3, 3, 3, 3, 3, 3, 3],
      [3, 0, 0, 0, 0, 0, 0, 3],
      [3, 0, 2, 2, 2, 2, 0, 3],
      [3, 0, 2, 0, 0, 2, 0, 3],
      [3, 0, 0, 0, 0, 0, 0, 3],
      [3, 3, 3, 3, 3, 3, 3, 3]
    ]
  },
  "ballSpeed": 8,
  "lives": 2,
  "powerUpChance": 0.55
} 