{
  "id": 5,
  "name": "Heart Breaker",
  "bricks": {
    "rows": 6,
    "cols": 8,
    "layout": [
      [0, 0, 3, 0, 0, 3, 0, 0],
      [0, 3, 3, 3, 3, 3, 3, 0],
      [3, 3, 3, 3, 3, 3, 3, 3],
      [3, 3, 3, 3, 3, 3, 3, 3],
      [0, 3, 3, 3, 3, 3, 3, 0],
      [0, 0, 3, 3, 3, 3, 0, 0]
    ]
  },
  "ballSpeed": 6,
  "lives": 3,
  "powerUpChance": 0.35
} 