{
  "id": 7,
  "name": "Happy Face",
  "bricks": {
    "rows": 6,
    "cols": 8,
    "layout": [
      [0, 0, 3, 3, 3, 3, 0, 0],
      [0, 3, 0, 0, 0, 0, 3, 0],
      [3, 0, 2, 0, 0, 2, 0, 3],
      [3, 0, 0, 0, 0, 0, 0, 3],
      [0, 3, 0, 0, 0, 0, 3, 0],
      [0, 0, 3, 3, 3, 3, 0, 0]
    ]
  },
  "ballSpeed": 7,
  "lives": 3,
  "powerUpChance": 0.45
} 